*****************************************************************
**        **********                    *******                 *
**  ***                ********  ** *** ******* **********  *   *
**  *****************  **     *  ** *** *       **       *  * ***
**  **             **  **  *     ** *** ******* **   *** *  * ***
**  **      **  *  **  **  *  ***** *** **   ** **   *** **** ***
**  **********  *  **  *****  ***     * **   ** **** ***    * ***
**              **            *** *** *      ** *    *** **** ***
******************  ************* *** ********* * ****** ***    *
*                *  ************* *** ********* *    *** ****** *
** ***  *******                   ***           ********        *
*   **  ************************* ************ *********  *******
*   **  *****         ********    **           **    ***  **    *
*   **          ***** *    *** ***** ********  **      *  **    *
****** ******** *     *    ***              *  **    * *  **  ***
*    * *    *   * ******* ****  ******* *****  **    * *  *     *
*           *   *               *       *      **    * *  *  *  *
****** ******* **  ***** ***************** *** ******* *  ****  *
*           *   *                    *                          *
*****************************************************************