*****************************************************************
*                                           **                  *
** ******** ** *** ***** ************ ****  *** *************** *
*        ** ** ***   ***           *    **  **                * *
*********** ** ***         *********    **  **          **** ** *
*        ** ** ***************************  **************** ** *
* ****** ** ** *          *                                   * *
*        ** ** * ******** *   ********************************* *
* ****** ** ** *  ***     *   *               ***           *** *
* *    * ** ** *  ***     *   * **********  *     ****** *  *** *
* *      ** ** *  ***     *   * *      ***  * *** **     *  *** *
* ********* ** *  ***         *        ***  * *** **     *  *   *
*           ** ************** ************  * *** **     *  * ***
* *********                 * *          *  * *** ********  * ***
* *       * ** ************ * *          *  *               * ***
* * **    * **              * * **********  ***************** ***
* * **    * ** ************ * *                                 *
* * **    * ** ***        * * ***********************************
* * **    * ** ***** ****** *                          *        *
* * **    *    ***          ******************  *****  *****  ***
* * **    * ** *******************************  *****  *****  ***
*   **    * ** **    *                          *****         ***
* ********* **  * *  *** *************  *************************
* *         **  * *  *               *  *                *****  *
* ********* **  * *  *****************  * ***** *******      *  *
* ***     * ***** *                       ***** *******  *   *  *
* ***     *     * ********  ******************* *******  ***** **
*         *  ****                *                  *           *
*****************************************************************